10
5
0000000000
0100000000
0010010000
0001000000
0000000000